13 10 3
##########
#        #
# #### # #
# #    # #
# # ## # #
# # ## # #
# # ## # #
# # #### #
#*#      #
# # ## ###
# # #    #
# # #  # #
##########
-11 5 3
##########
#        #
# #### # #
# #    # #
# # ## # #
# # ## # #
# # ## # #
# # #### #
#*#      #
# # ## ###
# # #    #
# # #  # #
##########