17 13 6
#############
#           #
# #### #    #
# #    #    #
# # ## #    # 
# # ## #    #
# # ## #    #
# # ####    # 
# #         #
# # ## ##   #
# # #       # 
# #    ###  #
# ## ###    #
#           # 
#           #
#      *    #
#############
15 10 4
##########
#        #
#*#### # #
# #    # #
# # ## # #
# # ## # #
# # ## # #
# # #### #
# #      #
# # ## ###
# # #    #
# #    # #
# ## ### #
#        #
##########
15 10 5
##########
#*       #
# #### # #
# #    # #
# # ## # #
# # ## # #
# # ## # #
# # #### #
# #      #
# # ## ###
# # #    #
# #    # #
# ## ### #
#        #
##########
17 13 6
#############
#           #
# #### #    #
# #    #    #
# # ## #    # 
# # ## #    #
# # ## #    #
# # ####    # 
# #         #
# # ## ##   #
# # #       # 
# #    ###  #
# ## ###    #
#           # 
#           #
#      *    #
#############
