13 25 1
##############################
#   *                        #
#    ###################     #
#           #         #      #
#                     #      #
#                     #      #
#                            #
# ###############            #
#                     ########
#                     #      #
#                     #      #
###############       #      #
##############################