15 10 2
##########
#      ###
# #### ###
# #    ###
# # ######
# # ######
# # ######
# # ######
# #    ###
# # ## ###
# # ##   #
# #  ### #
# ## ### #
#*##     #
##########
15 10 4
##########
#      ###
# #### ###
# #    ###
# # ######
# # ######
# # ######
# # ######
# #    ###
# # ## ###
# # ##   #
# #  ### #
# ###### #
#    *   #
##########
