13 110 3
##########
#        #
# #### # #
# #    # #
# # ## # #
# # ## # #
# # ## # #
# # #### #
#*#      #
# # ## ###
# # #    #
# # #  # #
##########
11 5 3
##########
#        #
# #### # #
# #    # #
# # ## # #
# # ## # #
# # ## # #
# # #### #
#*#      #
# # ## ###
# # #    #
# # #  # #
##########