5 28 3
############################
#   *         #         #  #
#      # #    #     #   #  #
# #    # #          #      #
############################
8 19 3
###################
#    *            #
#          ########
#  #       #      #
#  #     # #      #
#  #    #  ########
# # ## #          # 
###################
0 8 6
########
#    * #
# ######
# #    #
########